wwwwwwwwwwwwwwwwwwwwwwww
w......w............w..w
w..w.....A...w....c..g.w
w........c...w.........w
w..c.....w.....c.......w
w...w..c...............w
w..........cw...w......w
w....c...www...........w
w....w...c...c.........w
w.w....w............w..w
wwwwwwwwwwwwwwwwwwwwwwww