wwwwwwwwwwwwwwwwwwwwwwww
w....A.w.....c......w..w
w..w.........w.........w
w.c.....wc...w.........w
w........w..c..c.......w
w...w..c...........c...w
w..........ww...w......w
w..w.c....ww...........w
w........c.............w
w.w....w.....g......w..w
wwwwwwwwwwwwwwwwwwwwwwww