wwwwwwwwwwwwwwwwwwwwwwww
w......w...c.w.........w
w..c.A............w....w
w........c.............w
w..w.....c.....w.......w
w.c....w.........c.....w
w.........cw...........w
w..c.w.....w.....w.....w
w............w...c...c.w
w.........g............w
wwwwwwwwwwwwwwwwwwwwwwww