wwwwwwwwwwwwwwwwwwwwwwwwwwwwwwwwwwwwwwwwwwwwwwww
w.............................................gw
wn..............................ww............gw
w............................wwwww............gw
whwww.wwwww.wwwww.www.ww......................gw
wh.....................w......................gw
wh.....................w......................gw
wA.....................w......................gw
wwwwwwwwwwwwwwwwwwwwwwwwwwwwwwwwwwwwwwwwwwwwwwww